#######################################
# Datatypes (KEYWORD1)
#######################################
PageArgument	KEYWORD1
PageBuilder	KEYWORD1
PageElement	KEYWORD1

#######################################
# Methods and Functions (KEYWORD2)
#######################################
addElement	KEYWORD2
addToken	KEYWORD2
arg	KEYWORD2
argName	KEYWORD2
args	KEYWORD2
atNotFound	KEYWORD2
authentication	KEYWORD2
build	KEYWORD2
cancel	KEYWORD2
clearElements	KEYWORD2
exitCanHandle	KEYWORD2
insert	KEYWORD2
hasArg	KEYWORD2
mold	KEYWORD2
push	KEYWORD2
setMold	KEYWORD2
setUri	KEYWORD2
size	KEYWORD2
source	KEYWORD2
uri	KEYWORD2
